10 10
1101111011
0000011011
1111111011
0000011011
1101111011
